Ngân hàng là ngành có tỷ lệ Doanh nghiệp đạt Chuẩn CBTT năm 2022 cao nhất thị trường. Cụ thể, ngành này có 13/19 Doanh nghiệp đạt Chuẩn CBTT năm 2022, tương đương tỷ lệ hơn 68.4%. Công nghệ thông tin, bất động sản, xây dựng, vật liệu xây dựng, chế biến thủy sản và bán buôn là những ngành có tỷ lệ Doanh nghiệp đạt Chuẩn CBTT năm 2022 dưới 50%.
Ngân hàng là ngành công bố thông tin tốt nhất thị trường
Xét trên những ngành tiêu biểu, ngân hàng là ngành có tỷ lệ Doanh nghiệp đạt Chuẩn CBTT năm 2022 cao nhất thị trường. Đây là ngành được biết đến với vốn hóa thị trường thường xuyên ở mức lớn nhất, lợi nhuận cao nhất. Cụ thể, ngành này có 13/19 Doanh nghiệp đạt Chuẩn CBTT năm 2022, tương đương tỷ lệ hơn 68.4%. Đây là con số rất đáng mừng với một ngành được xem là trụ cột chính của thị trường chứng khoán Việt Nam trong suốt nhiều năm qua.
Trong số các gương mặt đạt Chuẩn CBTT của ngành này có rất nhiều cái tên đình đám và thường xuyên đạt được các giải thưởng quốc tế cũng như trong nước. Danh sách 13 Ngân hàng đạt Chuẩn CBTT năm 2022 bao gồm (xếp theo thứ tự ABC của mã chứng khoán):
- Ngân hàng TMCP Á Châu (HOSE: ACB)
- Ngân hàng TMCP Bắc Á (HNX: BAB)
- Ngân hàng TMCP Công Thương Việt Nam (HOSE: CTG)
- Ngân hàng TMCP Phát triển TP. HCM (HOSE: HDB)
- Ngân hàng TMCP Bưu điện Liên Việt (HOSE: LPB)
- Ngân hàng TMCP Quân Đội (HOSE: MBB)
- Ngân hàng TMCP Hàng hải Việt Nam (HOSE: MSB)
- Ngân hàng TMCP Quốc Dân (HNX: NVB)
- Ngân hàng TMCP Phương Đông (HOSE: OCB)
- Ngân hàng TMCP Đông Nam Á (HOSE: SSB)
- Ngân hàng TMCP Kỹ thương Việt Nam (HOSE: TCB)
- Ngân hàng TMCP Tiên Phong (HOSE: TPB)
- Ngân hàng TMCP Quốc tế Việt Nam (HOSE: VIB)
Ngành bán lẻ vươn lên vị trí thứ hai khi có 15/22 doanh nghiệp tuân thủ tốt hoạt động CBTT, với tỷ lệ đạt chuẩn là 68.2%. Đây có thể coi là một bất ngờ lớn vì ngành này thường chỉ nằm trong nhóm trung bình ở các năm trước. Trong Top 3 các ngành có tỷ lệ đạt Chuẩn CBTT tốt nhất thị trường (ngân hàng, bán lẻ và chứng khoán) thì bán lẻ là ngành tiến bộ nhiều nhất (tỷ lệ đạt Chuẩn CBTT của năm 2021 chỉ ở mức 55%).
TỶ LỆ ĐẠT CHUẨN CBTT NĂM 2021 & 2022 CỦA NGÀNH NGÂN HÀNG, BÁN LẺ VÀ CHỨNG KHOÁN

Nguồn: Báo cáo khảo sát về hoạt động CBTT trên thị trường chứng khoán năm 2021 và 2022
Danh sách 15 Doanh nghiệp ngành bán lẻ đạt Chuẩn CBTT năm 2022 bao gồm (xếp theo thứ tự ABC của mã chứng khoán):
- CTCP Dịch vụ Hàng không Taseco (HOSE: AST)
- CTCP Đầu tư Phát triển Công nghiệp Thương mại Củ Chi (HOSE: CCI)
- CTCP Dịch vụ Sân bay Quốc tế Cam Ranh (HNX: CIA)
- CTCP Thương nghiệp Cà Mau (HOSE: CMV)
- CTCP Vật tư Xăng Dầu (HOSE: COM)
- CTCP City Auto (HOSE: CTF)
- CTCP Bán lẻ Kỹ thuật số FPT (HOSE: FRT)
- CTCP Dịch vụ Ô tô Hàng Xanh (HOSE: HAX)
- CTCP Thương mại Hóc Môn (HNX: HTC)
- CTCP Đầu tư Thế giới Di động (HOSE: MWG)
- CTCP Văn hóa Phương Nam (HOSE: PNC)
- CTCP Tập đoàn Vexilla Việt Nam (HNX: SVN)
- CTCP Thương mại Xuất nhập khẩu Thủ Đức (HNX: TMC)
- Tổng Công ty Viglacera – CTCP (HOSE: VGC)
- CTCP Thương mại và Đầu tư VI NA TA BA (HNX: VTJ)
Bám sát ngành bán lẻ là lĩnh vực chứng khoán. Đây là ngành dẫn đầu về tỷ lệ DNNY đạt Chuẩn CBTT trong năm 2021 và cán đích ở vị trí thứ ba trong năm 2022 với tỷ lệ DNNY đạt Chuẩn CBTT là 67% (bao gồm 16/24 doanh nghiệp). Danh sách 16 Công ty chứng khoán đạt Chuẩn CBTT năm 2022 bao gồm (xếp theo thứ tự ABC của mã chứng khoán):
- CTCP Chứng khoán Agribank (HOSE: AGR)
- CTCP Chứng khoán Châu Á Thái Bình Dương (HNX: APS)
- CTCP Chứng khoán Bảo Việt (HNX: BVS)
- CTCP Chứng khoán Everest (HNX: EVS)
- CTCP Chứng khoán FPT (HOSE: FTS)
- CTCP Chứng khoán Hòa Bình (HNX: HBS)
- CTCP Chứng khoán Guotai Junan Việt Nam (HNX: IVS)
- CTCP Chứng khoán MB (HNX: MBS)
- CTCP Chứng khoán Dầu khí (HNX: PSI)
- CTCP Chứng khoán Sài Gòn - Hà Nội (HNX: SHS)
- CTCP Chứng khoán SSI (HOSE: SSI)
- CTCP Chứng khoán Trí Việt (HOSE: TVB)
- CTCP Chứng khoán Bản Việt (HOSE: VCI)
- CTCP Chứng khoán Rồng Việt (HOSE: VDS)
- CTCP Chứng khoán VIX (HOSE: VIX)
- CTCP Chứng khoán VNDirect (HOSE: VND)
Ngành bất động sản luôn “ổn định” ở vị trí áp chót
Công nghệ thông tin, bất động sản, xây dựng, vật liệu xây dựng, chế biến thủy sản và bán buôn là những ngành có tỷ lệ Doanh nghiệp đạt Chuẩn CBTT năm 2022 dưới 50%. Trong đó, ngành bất động sản vẫn luôn “ổn định” ở vị trí áp chót với 33/79 doanh nghiệp tuân thủ tốt hoạt động CBTT, tỷ lệ đạt chuẩn là 42%.
SỐ LƯỢNG DNNY ĐẠT CHUẨN VÀ KHÔNG ĐẠT CHUẨN CBTT NĂM 2022 THEO NHÓM NGÀNH

Nguồn: Báo cáo khảo sát về hoạt động CBTT trên thị trường chứng khoán năm 2022
Ngành thực phẩm - đồ uống đã vươn lên vị trí thứ 2 về vốn hóa thị trường
Trên phương diện vốn hóa thị trường thì cũng có một sự thay đổi rất đáng chú ý. Nếu như trong năm trước, ngành bất động sản và ngân hàng thường xuyên thay nhau chiếm giữ hai vị trí hàng đầu thì năm nay ngành thực phẩm - đồ uống đã vươn lên vị trí thứ 2. Ngành thực phẩm - đồ uống có tỷ lệ Doanh nghiệp đạt Chuẩn CBTT năm 2022 là 64%, xếp vị trí thứ 5.
SO SÁNH VỐN HÓA THỊ TRƯỜNG CỦA CÁC DNNY ĐẠT CHUẨN CBTT NĂM 2022 THEO NHÓM NGÀNH

Nguồn: Báo cáo khảo sát về hoạt động CBTT trên thị trường chứng khoán năm 2022
* Báo cáo khảo sát toàn diện về hoạt động CBTT trên thị trường chứng khoán năm 2022: Xem tại đây
Phòng Tư vấn Vietstock
FILI